##########
#        #
# #      #
#        #
#        #
#        #
#  @ox#  #
#        #
#        #
##########